Accueil	->
Acheron	Le terme Acheron peut désigner :<ul>
Adeptus Titanicus (Homonymie)	Le terme Adeptus Titanicus peut désigner :<ul>
Agnathio	Agnathio peut désigner :<ul>
Agripinaa (Homonymie)	Le terme Agripinaa peut désigner :<ul>
Ajax	Le nom Ajax peut désigner :<ul>
Alaric	Le nom Alaric peut désigner :<ul>
Amareo	Le nom Amareo peut désigner :<ul>
Angels Penitent	Angels Penitent peut désigner :<ul>
Angels Resplendent	Angels Resplendent peut désigner :<ul>
Angelus	Le terme "Angelus" peut désigner:<ul>
Ansgar	Ansgar peut désigner :<ul>
Aphael	Aphael peut désigner :<ul>
Apocalypse	Apocalypse peut désigner :<ul>
Apôtre Noir (Homonymie)	Le terme Apôtre Noir peut désigner :<ul>
Aquila	"Aquila" peut désigner :<ul>
Araignée Spectrale	Le mot "Araignée Spectrale" peut désigner :<ul>
Araken	Le terme "Araken" peut désigner:<ul>
Argent Hammer	Argent Hammer peut désigner :<ul>
Armageddon (Homonymie)	Le terme "Armageddon" renvoi à :<ul>
Artemis	Artemis peut désigner :<ul>
Aryand	Aryand peut désigner :<ul>
Assaut sur Black Reach (Homonymie)	Le nom Assaut sur Black Reach peut désigner :<ul>
Astral Knights	Astral Knights peut désigner :<ul>
Athonos	Athonos peut désigner :<ul>
Avenger	Le terme Avenger peut désigner :<ul>
Bannon	Bannon peut désigner :<ul>
Barbarossa	Barbarossa est un terme qui peut désigner:<ul>
Battlefleet Gothic (Homonymie)	Le terme Battlefleet Gothic peut désigner :<ul>
Belial (Homonymie)	Le terme Belial peut désigner :<ul>
Bellerophon	Bellerophon peut désigner:<ul>
Bellus	Bellus est un terme pouvant désigner :<ul>
Bibliothèque Interdite	Bibliothèque Interdite est un terme qui peut désigner :<ul>
Black Legion (Homonymie)	"Black Legion" peut désigner :<ul>
Black Templars (Homonymie)	"Black Templars" peut faire référence à :<ul>
Blood Angels (Homonymie)	Blood Angels est un terme anglais qui peut désigner :<ul>
Bloodquest	Bloodquest est un terme qui peut désigner :<ul>
Boreas	Boreas peut désigner :<ul>
Brutus	"Brutus" peut désigner :<ul>
Cabale	Le terme "Cabale" peut désigner :<ul>
Canon à Fusion	Le terme Canon à Fusion peut désigner :<ul>
Canon à Plasma	Le terme Canon à Plasma peut désigner :<ul>
Capitaine	"Capitaine" est un titre pouvant désigner :<ul>
Castellan	Le terme Castellan peut désigner :<ul>
Centurion	Le terme Centurion peut désigner :<ul>
Chevaliers Gris (Homonymie)	"Chevaliers Gris" peut désigner :<ul>
Chronologie	Chronologie des événements survenus dans la Voie Lactée.<ul>
Cloten	Cloten est un terme qui peut désigner:<ul>
Colossus	Colossus est un terme qui peut désigner:<ul>
Conqueror	Conqueror peut désigner :<ul>
Conquest	Le terme Conquest peut désigner :<ul>
Corvus	"Corvus" peut désigner :<ul>
Cossos	Le terme Cossos peut désigner :<ul>
Coteaz (Homonymie)	"Coteaz" peut faire référence à :<ul>
Crassus	Le terme Crassus peut désigner :<ul>
Croisade de Feu	Croisade de Feu est un terme qui peut désigner:<ul>
Crucible	"Crucible" peut désigner :<ul>
Crucius	Crucius est un terme pouvant désigner :<ul>
Crusader	Crusader peut désigner :<ul>
Cyclops	"Cyclops" peut désigner :<ul>
Damnos	Damnos peut désigner :<ul>
Damoclès	Le terme "Damoclès" ou "Damocles" peut désigner:<ul>
Damos	Damos peut désigner :<ul>
Dante (Homonymie)	Dante est un nom qui peut désigner:<ul>
Dario	Dario peut désigner :<ul>
Dark Millennium	Le mot "Dark Millennium" peut désigner :<ul>
Dawn of War	L'expression Dawn of War désigne à l'origine une série de jeux de stratégie prenant place dans l'univers de Warhammer 40,000, et comprend les titres suivants :<ul>
Death Strike	Death Strike est un terme qui peut désigner:<ul>
Deathskull (Homonymie)	Le nom Deathskull peut désigner :<ul>
Deathwatch (Homonymie)	"Deathwatch" peut faire référence à :<ul>
Deathwing	Le mot "Deathwing" peut désigner :<ul>
Deimos	Le terme Deimos peut désigner:<ul>
Delos	Delos est un terme qui peut désigner :<ul>
Destroyer	Destroyer  est un terme qui peut désigner:<ul>
Dominion	Le nom Dominion peut désigner :<ul>
Drakken (Homonymie)	Drakken peut désigner :<ul>
Dreadnought	Le terme "Dreadnought" recouvre différentes variantes du même châssis :<ul>
Dévoreur	Le terme Dévoreur peut désigner :<ul>
Eidolon	Eidolon est un terme qui peut désigner :<ul>
Eisenhorn	"Eisenhorn" peut désigner :<ul>
Emperor's Shield	Emperor's Shield peut désigner :<ul>
Emperor's Storm	Emperor's Storm peut désigner :<ul>
Emperor's Swords	Emperor's Swords peut désigner :<ul>
Epathus	Epathus peut désigner :<ul>
Erasmus	Erasmus peut désigner :<ul>
Erebus (Homonymie)	Erebus est un terme pouvant désigner :<ul>
Escouade de Vétérans	Le terme "Escouade de Vétérans" peut désigner :<ul>
Excelsior	Excelsior peut désigner :<ul>
Excoriators	Excoriators peut désigner :<ul>
Exorcist (Homonymie)	Le terme Exorcist peut désigner :<ul>
Exsanguinator (Homonymie)	Exsanguinator est un terme qui peut désigner :<ul>
Exterminatus (Homonymie)	Le terme "Exterminatus" peut désigner :<ul>
Ezekiel	Le nom de "Ezekiel" est porté par :<ul>
Falchion	Le terme Falchion peut désigner :<ul>
Faucheur (Homonymie)	Le terme Faucheur est employé pour désigner :<ul>
Faustus	Le terme Faustus  peut désigner :<ul>
Fenn	Fenn peut désigner :<ul>
Fidelis	Fidelis est un terme pouvant désigner :<ul>
Fire Hawks (Homonymie)	Le terme Fire Hawks peut désigner :<ul>
Firedrake	Firedrake est un terme qui peut désigner:<ul>
Firestorm (Homonymie)	Firestorm est un nom qui peut désigner:<ul>
Fulgrim (Homonymie)	Fulgrim est un terme qui peut désigner :<ul>
Furio	Furio peut désigner:<ul>
Furion	Furion est un terme qui peut désigner :<ul>
Furioso	"Furioso" peut désigner :<ul>
Fusil Exitus	Le fusil Exitus est un fusil de sniper utilisé seulement par le Temple Vindicare.Il utilise trois types de munitions:<ul>
Gabriel	Le nom "Gabriel" a plusieurs désignations :<ul>
Galan	Galan peut désigner :<ul>
Gallio	Le nom Gallio peut désigner:<ul>
Garde d'Honneur	"Garde d'Honneur" peut désigner :<ul>
Gargouille	Gargouille peut désigner :<ul>
Garran	Garran peut désigner :<ul>
Gehenna	Le nom "Gehenna" peut désigner :<ul>
Genestealer (Homonymie)	"Genestealer" peut désigner :<ul>
Ghorstangrad	Ghorstangrad peut désigner :<ul>
Gideon	Gideon est un terme qui peut désigner:<ul>
Goliath	Le nom "Goliath" peut désigner :<ul>
Gorgone	"Gorgone" (ou "Gorgon") peut désigner :<ul>
Graia	Le nom Graia peut désigner :<ul>
Grand Maître	Grand Maître Suprême est un terme qui peut désigner :<ul>
Grand Maître Suprême	Grand Maître Suprême est un terme qui peut désigner :<ul>
Grokalibr'	Les Grokalibr' sont des pièces d'artillerie dirigées par des Grots. Il en existe trois types:<ul>
Grukk	Grukk peut désigner :<ul>
Hades	Hades est un terme qui peut désigner :<ul>
Hammer of Justice	Le nom Hammer of Justice peut désigner :<ul>
Harbinger	Harbinger peut désigner :<ul>
Helios	Helios peut désigner :<ul>
Helsreach	Helsreach peut désigner :<ul>
Hereticus	"Hereticus" peut faire référence à :<ul>
Hermia	Hermia peut désigner :<ul>
Hunter	Hunter peut désigner :<ul>
Hérésie d'Horus (Homonymie)	Du terme anglais Horus Heresy qui peut désigner :<ul>
Iax	Iax est un terme qui peut désigner:<ul>
Ice Serpents	Ice Serpents peut désigner :<ul>
Inceptor (Homonymie)	Le terme Inceptor peut désigner :<ul>
Incinerator (Homonymie)	Le terme Incinerator peut désigner :<ul>
Index Astartes	Le mot "Index Astartes" peut désigner :<ul>
Inferno	Inferno est un terme qui peut désigner :<ul>
Infernus	Infernus est un terme qui peut désigner :<ul>
Initiation (Space Marines)	L' Initiation d'un Space Marine désigne :<ul>
Intolerance	Le nom Hammer of Justice peut désigner :<ul>
Invictus	Invictus peut désigner :<ul>
Ironclad	Ironclad est un terme qui peut désigner :<ul>
Iscon	Le nom Iscon peut désigner :<ul>
Israfel	Israfel peut désigner :<ul>
Isstvan	Le nom d'origine Isstvan1,5,6,7, a parfois été écrit "Istvaan"2-4 ou par erreur "Istvan" [Quelle Source ?], et désigne :<ul>
Ixion	Ixion est un terme pouvant désigner :<ul>
Jarulek	Jarulek est un terme qui peut désigner:<ul>
Jubal	Jubal peut désigner :<ul>
Justaerin	Justaerin est un nom qui peut désigner:<ul>
Justicar (Homonymie)	Justicar est un nom qui peut désigner:<ul>
Kairos	"Kairos" peut désigner :<ul>
Kale	"Kale" désigne pour :<ul>
Kaurava	Le nom Kaurava peut désigner :<ul>
Kelman	Kelman peut désigner :<ul>
Kevin T. Chin	Kevin T. Chin (pseudo. 'Chenzan'2,3), est un illustrateur et contributeur des publications de Fantasy Flight Games.<ul>
Konor	Konor peut désigner :<ul>
Kraken	Kraken est un terme qui peut désigner:<ul>
Krast (Homonymie)	Le terme Krast peut désigner :<ul>
Ladon	Ladon peut désigner :<ul>
Lazarus	Lazarus peut désigner:<ul>
Learchus	Learchus peut désigner :<ul>
Leman Russ	Leman Russ est un terme qui peut désigner:<ul>
Lethe	Lethe peut désigner :<ul>
Levi	Levi peut désigner :<ul>
Librarium	Le terme "Librarium" peut désigner :<ul>
Loki	Loki peut désigner :<ul>
Lorenzo	Lorenzo est un terme qui peut désigner:<ul>
Lucius (Homonymie)	Le terme Lucius  peut désigner :<ul>
Lunar	Le nom "Lunar" est utilisé pour désigner :<ul>
Lysander	Lysander peut désigner :<ul>
Légion	Le mot "Légion" peut désigner :<ul>
Léviathan	Léviathan est un terme qui peut désigner:<ul>
Macharius	Macharius est un nom qui peut désigner:<ul>
Malcador	Malcador est un terme qui peut désigner:<ul>
Malleus	"Malleus" peut faire référence à :<ul>
Manticore	Le terme "Manticore" peut désigner :<ul>
Marduk	Le nom Marduk peut désigner :<ul>
Marik	Marik est un terme qui peut désigner :<ul>
Marius	Marius est un terme qui peut désigner :<ul>
Mark Harrison	Le nom de Mark Harrison est porté par :<ul>
Mechanicum (Homonymie)	Le terme Mechanicum peut désigner :<ul>
Medusa	Medusa est un terme qui peut désigner:<ul>
Meridian	Meridian peut désigner :<ul>
Minotaur	Minotaur est un terme qui peut désigner:<ul>
Mira	Le nom Mira est porté par :<ul>
Misericorde	Misericord est un terme pouvant désigner :<ul>
Mjolnir	Le terme Mjolnir peut désigner :<ul>
Mordant	Le nom Mordant peut désigner :<ul>
Mortis	Le terme Mortis peut désigner :<ul>
Necromunda	Necromunda peut désigner :<ul>
Nephilim	Nephilim peut désigner :<ul>
Night Lords (Homonymie)	"Night Lords" peut désigner :<ul>
Nightbringer (Homonymie)	Le nom Nightbringer peut désigner :<ul>
Nocturne (Homonymie)	Nocturne est un terme pouvant désigner :<ul>
Numitor	Numitor est un terme pouvant désigner :<ul>
Némésis	Le terme "Némésis" peut désigner :<ul>
Ophidian	Ophidian peut désigner :<ul>
Ophion	Ophion peut désigner :<ul>
Orestes	Orestes peut désigner :<ul>
Orion	Orion est un terme qui peut désigner:<ul>
Orpheus	Orpheus peut désigner :<ul>
Paladin	Le terme Paladin peut désigner :<ul>
Pardus	"Pardus" peut désigner :<ul>
Paria (Homonymie)	Le terme Paria peut désigner :<ul>
Personnages (Alpha Legion - Légion)	Liste des personnages connus appartenant à la XXème Légion de l'Alpha Legion lors de la Grande Croisade et de l'Hérésie d'Horus.La loyauté des membres de la Légion lors de l'Hérésie est indiquée comme suit :<ul>
Personnages (Dark Angels - Légion)	Liste des personnages connus appartenant à la Ière Légion des Dark Angels lors de la Grande Croisade et de l'Hérésie d'Horus.La loyauté des membres de la Légion lors de l'Hérésie est indiquée comme suit :<ul>
Personnages (Death Guard - Légion)	Liste des personnages connus appartenant à la XIVème Légion de la Death Guard lors de la Grande Croisade et de l'Hérésie d'Horus.La loyauté des membres de la Légion lors de l'Hérésie est indiquée comme suit :<ul>
Personnages (Emperor's Children - Légion)	Liste des personnages connus appartenant à la IIIème Légion des Emperor's Children lors de la Grande Croisade et de l'Hérésie d'Horus.La loyauté des membres de la Légion lors de l'Hérésie est indiquée comme suit :<ul>
Personnages (Iron Warriors - Légion)	Liste des personnages connus appartenant à la IVème Légion des Iron Warriors lors de la Grande Croisade et de l'Hérésie d'Horus.La loyauté des membres de la Légion lors de l'Hérésie est indiquée comme suit :<ul>
Personnages (Night Lords - Légion)	Liste des personnages connus appartenant à la VIIIème Légion des Night Lords lors de la Grande Croisade et de l'Hérésie d'Horus.La loyauté des membres de la Légion lors de l'Hérésie est indiquée comme suit :<ul>
Personnages (Sons of Horus)	Liste des personnages connus appartenant à la XVIème Légion des Lunar Wolves / Sons of Horus lors de la Grande Croisade et de l'Hérésie d'Horus.La loyauté des membres de la Légion lors de l'Hérésie est indiquée comme suit :<ul>
Personnages (Thousand Sons - Légion)	Liste des personnages connus appartenant à la XVème Légion des Thousand Sons lors de la Grande Croisade et de l'Hérésie d'Horus.La loyauté des membres de la Légion lors de l'Hérésie est indiquée comme suit :<ul>
Personnages (Word Bearers - Légion)	Liste des personnages connus appartenant à la XVIIème Légion des Word Bearers lors de la Grande Croisade et de l'Hérésie d'Horus.La loyauté des membres de la Légion lors de l'Hérésie est indiquée comme suit :<ul>
Personnages (World Eaters - Légion)	Liste des personnages connus appartenant à la XIIème Légion des World Eaters lors de la Grande Croisade et de l'Hérésie d'Horus.La loyauté des membres de la Légion lors de l'Hérésie est indiquée comme suit :<ul>
Phaedra	Phaedra est un terme qui peut désigner:<ul>
Phaeton	Phaeton peut désigner :<ul>
Portail:Lexicanum	Portails des Armées<ul>
Praetor	Praetor peut désigner :<ul>
Princeps	Le terme Princeps peut désigner :<ul>
Proteus	Proteus<ul>
Punisher	Punisher peut désigner :<ul>
Pythos	Pythos peut désigner :<ul>
Ragnar	"Ragnar" peut désigner :<ul>
Ragnarok	"Ragnarok"' peut désigner :<ul>
Raphael	Raphael est un terme qui peut désigner:<ul>
Raptors	Raptor est un terme qui peut désigner:<ul>
Ravageur (Homonymie)	Ravageur est un terme qui peut désigner:<ul>
Raven	"Raven" peut désigner :<ul>
Realm of Chaos	Realm of Chaos peut désigner:<ul>
Reborn	Reborn peut désigner :<ul>
Redeemed	Le terme Redeemed peut désigner :<ul>
Redwings (Homonymie)	Le terme Redwings peut désigner :<ul>
Retribution	Retribution est un terme pouvant désigner :<ul>
Righteous Fury	"Righteous Fury" peut faire référence à :<ul>
Righteous Power	Le nom Righteous Power peut désigner :<ul>
Rogal	Rogal peut désigner :<ul>
Rogue Trader (Homonymie)	L'expression "Rogue Trader" peut désigner :<ul>
Rynn	Rynn peut désigner :<ul>
Sabbat	Le terme de "Sabbat" peut désigner :<ul>
Salamander	Salamander est un terme qui peut désigner:<ul>
Santar	Santar peut désigner :<ul>
Scipio	Scipio peut désigner :<ul>
Scorpion	Le terme "Scorpion" peut désigner :<ul>
Sejanus	Sejanus peut désigner :<ul>
Semper	Semper peut désigner :<ul>
Sergent	Sergent peut désigner :<ul>
Seth	Le nom "Seth" peut désigner :<ul>
Severus	Le nom Severus peut désigner :<ul>
Shira Calpurnia	"Shira Calpurnia" peut faire référence à :<ul>
Sigismund (Homonymie)	Sigismund peut désigner :<ul>
Signus Daemonicus (Homonymie)	Signus Daemonicus peut désigner :<ul>
Silence	Silence est un terme qui peut désigner :<ul>
Simeon	Simeon peut désigner :<ul>
Sinon	Le terme Sinon peut désigner :<ul>
Solus	Solus est un terme qui peut désigner :<ul>
Somonor	Somonor peut désigner :<ul>
Space Hulk	Space Hulk est un terme qui peut désigner:<ul>
Space Marine (Homonymie)	"Space Marine" peut désigner :<ul>
Spectre of Death	Spectre of Death est un terme pouvant désigner :<ul>
Stern	Stern est un nom pouvant désigner :<ul>
Stygies	Stygies est un terme qui peut désigner:<ul>
Système	Système peut désigner :<ul>
Sénéchal	Sénéchal peut désigner :<ul>
Talos	Talos est un terme qui peut désigner:<ul>
Tamar	Tamar peut désigner :<ul>
Tancred	Tancred est un terme qui peut désigner :<ul>
Tarsis	Tarsis peut désigner :<ul>
Tartarus	Tartarus peut désigner :<ul>
Telemachus	Telemachus est un terme qui peut désigner :<ul>
Thanatos	Thanatos peut désigner :<ul>
Thor	Thor est un nom qui peut désigner:<ul>
Thoth	Thoth peut désigner :<ul>
Thrax	Thrax est un nom pouvant désigner:<ul>
Thule	Thule peut désigner :<ul>
Tiamat	Tiamat est un terme qui peut désigner:<ul>
Titan	"Titan peut désigner :<ul>
Titus	Le nom "Titus" est porté par :<ul>
Trajan	Trajan peut désigner :<ul>
Trojan	"Trojan" peut désigner :<ul>
Tycho	Le nom de Tycho peut signifier :<ul>
Typhon	Typhon peut désigner :<ul>
Tétrarque	Tétrarque peut désigner:<ul>
Ultramarines (Homonymie)	"Ultramarines" peut faire référence à :<ul>
Uriel Ventris (Homonymie)	"Uriel Ventris" peut faire référence à :<ul>
Valdor	"Valdor" est un nom pouvant désigner :<ul>
Valerius	Valerius peut désigner :<ul>
Varon	Varon est un terme qui peut désigner :<ul>
Varus	Varus peut désigner :<ul>
Venator	"Venator" peut désigner :<ul>
Victis	Victis peut désigner :<ul>
Victus (Homonymie)	Victus peut désigner :<ul>
Vior'la (Homonymie)	Le terme Vior'la peut désigner :<ul>
Voldorius	Voldorius peut désigner :<ul>
Warmaster	Le terme Warmaster peut désigner :<ul>
Warmongers (Homonymie)	Le terme Warmongers peut désigner :<ul>
Xavier (Homonymie)	Xavier peut désigner :<ul>
Xeno (Homonymie)	"Xeno" peut faire référence à :<ul>
Yarrick (Homonymie)	Yarrick peut désigner:<ul>
Yriel (Homonymie)	Le terme Yriel peut désigner :<ul>
